end=конец
label=метка
button=кнопка
function=функция
method=метод
happy=счастливый
married=женатый
single=одинокий
new=новый
old=старый
at home=дома
house=дом
busy=занятый
tired=уставший
friend=друг
funny=смешной
father=отец
idea=идея
good=хорший
bad=плохой
very=очень
pretty=красивый
car=машина
elevator=лифт
job=работа
sister=сестра
brother=брат
mather=мать
parent=родитель
child=ребенок
children=дети
time=время
watch=часы
listen=слушать
lesson=урок
read=читать
write=записать
use=использовать
book=книга
newspaper=новостная газета
computer=компьютер
TV=телевидение
eat=еда
drink=напиток
meat=мясо
milk=молоко
sugar=сахар
fish=рыба
meet=свидание
date=встречаться
wait=ждать
miss=скучать
hug=обнимать
appreciate=ценить
respect=уважать
beach=пляж
towel=полотенце
shade=тень
sunscreen=крем от загара
lifeguard=спасатель
swim=плавать
sunbathe=загорать
iron=гладить
hard=сильно
quietly=тихо
londly=громко
carefully=осторожно
patiently=терпеливо
accidentally=случайно
easily=легко
well=хорошо
badly=плохо
fast=быстро
some=сколько-то
somewhere=где-то
something=что-то
someone=кто то
somebody=кто-то
any=какой-либо
anywhere=где-либо
anything=что-либо
anyone=кто либо
anybody=кто-либо
require=требовать
serve=служить
mingle=смешивать
entertainment=развлечение
guest=гость
host=принимать
invite=приглашать
respond=отвечать
channel=канал
broadcast=трансляция
news=новости
game=матч
commercial=реклама
chocolate=шоколад
candy=конфета
toffee=ириска
caramel=карамель
marshmallow=зефир
syrup=сироп
jam=варенье
honey=мед
jelly=желе
fight=ссориться
forgive=прощать
continue=продолжать
care=заботиться
share=делиться
husband=муж
wife=жена
marry=жениться
relationship=отношения
boat=лодка
raft=плот
oar=весло
river=река
stream=течение
capsize=перевернуться
profit=прибыль
vault=сейф
atm=банкомат
deposit=депозит
loan=ссуда
mortgage=ипотека
check-in=регистрация
flight=рейс
delayed=задержанный
canceled=отмененный
baggage=багаж
customs=таможня
boarding=посадка на рейс
gate=выход на посадку
lie=лежать
run=бежать
do=делать
take=брать
lift=поднимать
put=класть
sit=сидеть
jump=прыгать
theater=театр
play=пьеса
audience=зрители
stage=сцена
costume=костюм
mask=маска
makeup=грим
monolugue=монолог
dialogue=диалог
applause=аплодисменты
explain=объяснять
understand=понимать
cheat=списывать
lesson=урок
test=тест
exam=экзамен
grade=оценка
question=вопрос
answer=ответ
ask=спрашивать
late=поздний
early=ранний
oversleep=проспать
hurry=спешить
miss=пропускать
postpone=откладывать
schedule=расписание
convince=убеждать
promise=обещать
guarantee=гарантировать
agree=согласен
disagree=не согласен
vote=голосовать
elect=ввыбирать
run=запускать
control=контроль
improve=улучшать
talent=талант
capability=способность
inclination=склонность
skill=навык
diligence=трудолюбие
effort=усилие
commitment=обязательство
accomplishment=достижение
experience=опыт
proficiency=мастерство
stylish=стильный
trendly=модный
comfortable=удобный
elegant=елегантный
dowdy=старомодный
tight=тесный
baddy=свободный
dressy=нарядный
expensive=дорогой
cheap=дешевый
mom=мама
dad=папа
son=сын
daughter=дочь
grandfather=дедушка
grandmother=бабушка
granddaughter=внучка
grandson=внук
tuna=тунец
shrimp=креветка
squid=кальмар
octopus=осьминог
mussel=мидия
oyster=устрица
lobster=лобстер
caviar=черная икра
salmon=лосось
peanut=арахис
walnut=грецкий орех
almond=миндаль
hazelnut=лесной орех
pistachio=фисташка
pecan=орех пекан